ddate	bigint,
timestamp	bigint,
version	int,
alt_heat_delivery	varchar(100),
alt_heat_source	varchar(100),
alt_heat_x2_delivery	varchar(100),
alt_heat_x2_source	varchar(100),
auto_away	int,
auto_away_enable	varchar(5),
auto_away_learning	varchar(20),
auto_away_reset	varchar(5),
auto_dehum_enabled	varchar(5),
auto_dehum_state	varchar(5),
aux_heat_delivery	varchar(20),
aux_heat_source	varchar(20),
aux_lockout_leaf	decimal(11,1),
available_locales	varchar(100),
away_temperature_high	decimal(11,3),
away_temperature_high_enabled	varchar(5),
away_temperature_low	decimal(11,3),
away_temperature_low_enabled	varchar(5),
backplate_bsl_info	varchar(20),
backplate_bsl_version	decimal(3,1),
backplate_model	varchar(20),
backplate_mono_info	varchar(100),
backplate_mono_version	varchar(10),
backplate_serial_number	varchar(20),
battery_level	decimal(5,3),
can_cool	varchar(5),
can_heat	varchar(5),
capability_level	decimal(3,1),
click_sound	varchar(3),
compressor_lockout_enabled	varchar(5),
compressor_lockout_leaf	decimal(4,1),
compressor_lockout_timeout	int,
cooling_delivery	varchar(20),
cooling_source	varchar(20),
cooling_x2_delivery	varchar(20),
cooling_x2_source	varchar(20),
country_code	varchar(5),
creation_time	bigint,
current_humidity	int,
current_schedule_mode	varchar(20),
current_temperature	decimal(5,2),
current_version	varchar(10),
dehumidifier_orientation_selected	varchar(20),
dehumidifier_state	varchar(5),
dehumidifier_type	varchar(20),
device_locale	varchar(20),
dual_fuel_breakpoint	int,
dual_fuel_breakpoint_override	varchar(20),
emer_heat_delivery	varchar(20),
emer_heat_enable	varchar(5),
emer_heat_source	varchar(20),
equipment_type	varchar(20),
error_code	varchar(20),
fan_control_state	varchar(5),
fan_cooling_enabled	varchar(5),
fan_cooling_readiness	varchar(20),
fan_cooling_state	varchar(5),
fan_duty_cycle	int,
fan_duty_end_time	int,
fan_duty_start_time	int,
fan_mode	varchar(20),
fan_timer_duration	int,
fan_timer_timeout	int,
filter_changed_date	int,
filter_changed_set_date	int,
filter_reminder_enabled	varchar(5),
filter_reminder_level	int,
forced_air	varchar(5),
gear_threshold_high	int,
gear_threshold_low	int,
has_air_filter	varchar(5),
has_alt_heat	varchar(5),
has_aux_heat	varchar(5),
has_dehumidifier	varchar(5),
has_dual_fuel	varchar(5),
has_emer_heat	varchar(5),
has_fan	varchar(5),
has_fossil_fuel	varchar(5),
has_heat_pump	varchar(5),
has_humidifier	varchar(5),
has_x2_alt_heat	varchar(5),
has_x2_cool	varchar(5),
has_x2_heat	varchar(5),
has_x3_heat	varchar(5),
heat_link_connection	varchar(5),
heat_pump_aux_threshold	decimal(3,1),
heat_pump_aux_threshold_enabled	varchar(5),
heat_pump_comp_threshold	decimal(3,1),
heat_pump_comp_threshold_enabled	varchar(5),
heat_x2_delivery	varchar(20),
heat_x2_source	varchar(20),
heat_x3_delivery	varchar(20),
heat_x3_source	varchar(20),
heater_delivery	varchar(20),
heater_source	varchar(20),
heatpump_ready	varchar(5),
heatpump_savings	varchar(20),
heatpump_setback_active	varchar(5),
humidifier_state	varchar(5),
humidifier_type	varchar(20),
humidity_control_lockout_enabled	varchar(5),
humidity_control_lockout_end_time	bigint,
humidity_control_lockout_start_time	bigint,
hvac_ac_state	varchar(5),
hvac_alt_heat_state	varchar(5),
hvac_alt_heat_x2_state	varchar(5),
hvac_aux_heater_state	varchar(5),
hvac_cool_x2_state	varchar(5),
hvac_emer_heat_state	varchar(5),
hvac_fan_state	varchar(5),
hvac_heat_x2_state	varchar(5),
hvac_heat_x3_state	varchar(5),
hvac_heater_state	varchar(5),
hvac_pins	varchar(100),
hvac_safety_shutoff_active	varchar(5),
hvac_wires	varchar(200),
is_on_stand	int,
leaf	varchar(5),
leaf_away_high	decimal(5,2),
leaf_away_low	decimal(5,2),
leaf_learning	varchar(20),
leaf_schedule_delta	decimal(5,2),
leaf_threshold_cool	decimal(5,3),
leaf_threshold_heat	decimal(5,3),
leaf_type	int,
learning_days_completed_cool	int,
learning_days_completed_heat	int,
learning_days_completed_range	int,
learning_mode	varchar(5),
learning_state	varchar(20),
learning_time	int,
local_ip	varchar(15),
logging_priority	varchar(20),
lower_safety_temp	decimal(5,3),
lower_safety_temp_enabled	varchar(5),
mac_address	varchar(20),
maint_band_lower	int,
maint_band_upper	int,
model_version	varchar(20),
name	varchar(100),
nlclient_state	varchar(20),
note_codes	varchar(20),
ob_orientation	varchar(20),
ob_persistence	varchar(5),
pin_c_description	varchar(20),
pin_g_description	varchar(20),
pin_ob_description	varchar(20),
pin_rc_description	varchar(20),
pin_rh_description	varchar(20),
pin_star_description	varchar(20),
pin_w1_description	varchar(20),
pin_w2aux_description	varchar(20),
pin_y1_description	varchar(20),
pin_y2_description	varchar(20),
postal_code	varchar(6),
preconditioning_active	varchar(5),
preconditioning_enabled	varchar(5),
preconditioning_ready	varchar(5),
radiant_control_enabled	varchar(5),
range_enable	varchar(5),
rssi	decimal(3,1),
safety_temp_activating_hvac	varchar(5),
schedule_learning_reset	varchar(5),
serial_number	varchar(20),
star_type	varchar(20),
sunlight_correction_active	varchar(5),
sunlight_correction_enabled	varchar(5),
sunlight_correction_ready	varchar(5),
switch_preconditioning_control	varchar(5),
switch_system_off	varchar(5),
target_change_pending	varchar(5),
target_humidity	decimal(3,1),
target_humidity_enabled	varchar(5),
target_temperature	decimal(5,3),
target_temperature_high	decimal(3,1),
target_temperature_low	decimal(3,1),
target_temperature_type	varchar(20),
target_time_confidence	decimal(3,1),
temperature_lock	varchar(5),
temperature_lock_high_temp	decimal(5,3),
temperature_lock_low_temp	decimal(3,1),
temperature_lock_pin_hash	varchar(100),
temperature_scale	varchar(5),
time_to_target	int,
time_to_target_training	varchar(20),
touched_by	varchar(20),
type	varchar(20),
upper_safety_temp	decimal(3,1),
upper_safety_temp_enabled	varchar(5),
user_brightness	varchar(20),
y2_type	varchar(20),
z_temperature	decimal(5,1),
z_relative_humidity	decimal(3,0),
z_wind_dir	varchar(5),
z_wind_degrees	decimal(3,0),
z_wind_speed	decimal(4,1),
z_wind_gust_speed	decimal(4,1),
z_pressure	smallint,
z_pressure_trend	varchar(5),
z_dewpoint	int,
z_heat_index	varchar(5),
z_windchill	varchar(5),
z_feelslike	decimal(3,1),
z_visibility	decimal(3,1),
z_UV	int,
z_precip_today	decimal(4,1)

